00000000000000000000000000
00000000000000000000000000
00bb00bb00bb00bb00bb00bb00
00bb00bb00bb00bb00bb00bb00
00bb00bb00bb00bb00bb00bb00
00bb00bb00bb00bb00bb00bb00
00bb00bb00bbssbb00bb00bb00
00bb00bb00bbssbb00bb00bb00
00bb00bb00bb00bb00bb00bb00
00bb00bb0000000000bb00bb00
00bb00bb0000000000bb00bb00
0000000000bb00bb0000000000
0000000000bb00bb0000000000
bb00bbbb0000000000bbbb00bb
ss00bbbb0000000000bbbb00ss
0000000000bb00bb0000000000
0000000000bbbbbb0000000000
00bb00bb00bbbbbb00bb00bb00
00bb00bb00bb00bb00bb00bb00
00bb00bb00bb00bb00bb00bb00
00bb00bb00bb00bb00bb00bb00
00bb00bb0000000000bb00bb00
00bb00bb0000000000bb00bb00
00bb00bb000bbbb000bb00bb00
00000000000b00b00000000000
00000000000b00b00000000000