00bb00bb00bb00bb00bb00bb00
00bb00bb00bb00bb00bb00bb00
00bb00bb00bb00bb00bb00bb00
00bb00bb00bb00bb00bb00bb00
00ss00ss00ss00ss00ss00ss00
00000000000000000000000000
00000000bb000000bb00000000
bb00bb00bb000000bb00bb00bb
bb00bbbbbb00bb00bbbbbb00bb
bb00bb00bb00bb00bb00bb00bb
ss00ss00ss00ss00ss00ss00ss
00000000ss000000ss00000000
tttt0000bb00tt00bb0000tttt
tttt0000bb00tt00bb0000tttt
ttttttttbbbbttbbbbtttttttt
ttttttttbb00tt00bbtttttttt
tttttttttttttttttttttttttt
tttttttttttttttttttttttttt
00000000bbttttttbb00000000
bb00bb00bbttttttbb00bb00bb
00bb00bb0000tt0000bb00bb00
00bb00bb0000tt0000bb00bb00
00bb00bb0000000000bb00bb00
00bb00bb000bbbb000bb00bb00
00bb00bb000b00b000bb00bb00
00000000000b00b00000000000