00000000000000000000000000
00000000000000000000000000
00ss00ss00ss00ss00ss00ss00
00ss00ss00ss00ss00ss00ss00
00ss00ss00ss00ss00ss00ss00
00ss00ss00ss00ss00ss00ss00
00ss00ss00ssbbss00ss00ss00
00ss00ss00ssbbss00ss00ss00
00ss00ss00ss00ss00ss00ss00
00ss00ss0000000000ss00ss00
00ss00ss0000000000ss00ss00
0000000000ss00ss0000000000
0000000000ss00ss0000000000
ss00ssss0000000000ssss00ss
bb00ssss0000000000ssss00bb
0000000000ss00ss0000000000
0000000000ssssss0000000000
00ss00ss00ssssss00ss00ss00
00ss00ss00ss00ss00ss00ss00
00ss00ss00ss00ss00ss00ss00
00ss00ss00ss00ss00ss00ss00
00ss00ss0000000000ss00ss00
00ss00ss0000000000ss00ss00
00ss00ss000ssss000ss00ss00
00000000000s00s00000000000
00000000000s00s00000000000